1111111111
1000000001
1011111101
1000000001
1011111101
1000100001
1010101101
1000000001
1000100001
1111111111