11111111111111111111
11010010111001010011
11010010100101100101
11001110010110111011
10100000000010011111
10001101000010010011
10100110101110101001
10010001100110111001
10010110110110101101
11111000000001011101
10101011010000100111
10001110111101110111
10010110100001111101
11111000101000110011
10111010011010100111
10010100101100111001
10000101010000000111
11100100011000011011
11000101101111011001
11111111111111111111